111111111111111
111111110000011
10000C000C00001
10C010100100001
111111111111101
11000000P010001
1E0000000000001
111111111111111