111111111111111
10C000000C00E01
10000C000100001
10C010000P00001
111111111111111