111111111111111
111111110000011
10001C000C00E01
10C010100100001
10000000P010011
100000000000001
111111111111111